NO ./textures_imgs/ChatGPT0.png
SO ./textures_imgs/ChatGPT1.png
WE ./textures_imgs/ChatGPT2.png
EA ./textures_imgs/ChatGPT2.png

F 20,100,0
C 225,30,0

2111111111111111111111111
1000000000110000000000001
1011000001110000000000001
1001000000000000000000001
1111111110110000011100001
1000000000110000011101111
1111011111111101110000001
1111011111111101110100011
1111011111111101110100011
1111011111111101110100011
1100000011010101110000011
1000000000000000110000011
1000000000000000110010011
11000001110101011110N0111
11110111 1110101 10111011
11111111 1111111 11111111
