1111111111111111111111111
1000000000110000000000001
1011000001110000000000001
1001000000000000000000001
1111111101100000111010101
10000000001100N0011101011
1111011111000001110001011
1111011111111101110101001
1100000011010101110000001
1000000000000000110000001
1000000000000000110101001
1100000111010101111111111
1111011111101011111111001
1111111111111111111111111