1111111111111111111111111
1000000000110000000000001
1011000001110000000000001
1001000000000000000000001
1111111101100000111010101
10000000001100N0011101011
1111011111000001110001011
1111011111111101110101001
1100000011010101110000001
1000000000000000110000001
1000000000000000110101001
1100000111010101111111111
1111011111101011111111001
1111111111111111111111111


111111111111111111111111
100000000000000000000001
100000000000000000000001
100000000000000000000001
100000111110000101010001
100000100010000000000001
100000100010000100010001
100000100010000000000001
100000110110000101010001
100000000000000000000001
100000000000000000000001
100000000000000000000001
100000000000000000000001
10000000000N000000000001
100000000000000000000001
100000000000000000000001
111111111000000000000001
110100001000000000000001
110000101000000000000001
110100001000000000000001
110111111000000000000001
110000000000000000000001
111111111000000000000001
111111111111111111111111


SO ./textures_imgs/wall.xpm
NO ./textures_imgs/eagle.xpm    

WE ./textures_imgs/bluestone.xpm 
EA ./textures_imgs/greystone.xpm

C 0,0,255
F 0,0,2

1111111111111
1000000000001
1000000000001
1000001000001
1000000100001
1000001000001
100000N100001
1000001000001
1111111111111