SO ./textures_imgs/AnyConv.com__wall_texture_3.xpm   
NO ./textures_imgs/AnyConv.com__wall_texture_7.xpm
WE ./textures_imgs/AnyConv.com__wall_texture_12.xpm
EA ./textures_imgs/greystone.xpm

F 50,50,50
C 135,206,235

11111111111111111111111111111111111111111111111111
10000000000000000000000000000000000000000000000001
10111111111111111111110000111111111111111111111101
10100000000000000000010000100000000000000000000101
10101111111111111110010000101111111111111111110101
10101000000000000010010000100000000000000000010101
10101011111111111010010000101111111111111110010101
10101010000000001010010000100000000000000010010101
10101010111111101010010000101111111111111010010101
10101010100000101010010000100000000000001010010101
10101010101110101010010000101111111111101010010101
10101010101010101010010000100000000000101010010101
10101010101010101010010000111111111110101010010101
10101010101010101010010000000000000010101010010101
10101010101010101010011111111111110010101010010101
10101010101010101010000000000000010010101010010101
10101010101010101011111111111111010010101010010101
10101010101010101000000000000001010010101010010101
10101010101010101111111111111101010010101010010101
10101010101010100000000000000101010010101010010101
10101010101010111111111111110101010010101010010101
10101010101010000000000000010101010010101010010101
10101010101011111111111111010101010010101010010101
10101010101000000000000001010101010010101010010101
10101010101111111111111101010101010010101010010101
10101010100000000000000101010101010010101010010101
10101010111111111111110101010101010010101010010101
10101010000000000000010101010101010010101010010101
10101011111111111111010101010101010010101010010101
10101000000000000001010101010101010010101010010101
10101111111111111101010101010101010N10101010010101
10100000000000000101010101010101010010101010010101
10111111111111110101010101010101010010101010010101
10000000000000010101010101010101010010101010010101
10111111111111010101010101010101010010101010010101
10000000000001010101010101010101010010101010010101
11111111111101010101010101010101010010101010010101
10000000000101010101010101010101010010101010010101
10111111110101010101010101010101010010101010010101
10100000010101010101010101010101010010101010010101
10101111010101010101010101010101010010101010010101
10101001010101010101010101010101010010101010010101
10101101010101010101010101010101010010101010010101
10101001010101010101010101010101010010101010010101
10101101010101010101010101010101010010101010010101
10101001010101010101010101010101010010101010010101
10101001010101010101010101010101010010101010010101
10101001010101010101010101010101010010101010010101
10101001010101010101010101010101010010101010010101
10101001010101010101010101010101010010101010010101
10101001000000000000000000000000000000000000000101
10101001111111111111111111111111111111111111110101
10101000000000000000000000000000000000000000000101
10101111111111111111111111111111111111111111111101
10100000000000000000000000000000000000000000000001
11111111111111111111111111111111111111111111111111
