SO ./textures_imgs/wall.xpm   
NO ./textures_imgs/eagle.xpm
WE ./textures_imgs/bluestone.xpm 
EA ./textures_imgs/greystone.xpm

C 0,0,255
F 0,0,2

11111
11N11
11111








