SO ./textures_imgs/ChatGPT0.xpm   
NO ./textures_imgs/eagle.xpm
WE ./textures_imgs/bluestone.xpm 
EA ./textures_imgs/greystone.xpm                           

C 0,0,25
F 0,0,2

1111111111111
1000000000001
1000000000001
1000001000001
1000000100001
1000001000001
1000000100001
1000001000N01
1111111111111
