NO ./textures_imgs/eagle.xpm
SO ./textures_imgs/redbrick.xpm   
WE ./textures_imgs/bluestone.xpm 
EA ./textures_imgs/greystone.xpm

F 0,0,0
C 0,0,255

1111111111111111111111111
1000000000000000000000001
1000000000000000000000001
1000000000000000000000001
1000000000000000000000001
1000000000000000000000001
1000000000000000000000001
1000000000000000000000001
1000000000000000000000001
100000000000000N000000001
1000000000000000000000001
1000000000000000000000001
1000000000000000000000001
1111111111111111111111111




