NO ./textures_imgs/ChatGPT Image Nov 17, 2025, 01_20_41 AM.png
SO ./textures_imgs/ChatGPT Image Nov 17, 2025, 01_22_32 AM.png
WE ./textures_imgs/ChatGPT Image Nov 17, 2025, 01_30_35 AM.png
EA ./textures_imgs/ChatGPT Image Nov 17, 2025, 01_30_35 AM.png

F 20,100,0
C 225,30,0

2111111111111111111111111
1000000000110000000000001
1011000001110000000000001
1001000000000000000000001
111111111011000001110000000000000
100000000011000001110111111111111
11110111111111011100000010001
11110111111111011101010010001
11000000110101011100000010001
10000000000000001100000010001
10000000000000001101010010001
11000001110101011111011110N0111
11110111 1110101 101111010001
11111111 1111111 111111111111
