NO ./textures_imgs/north.xpm
SO ./textures_imgs/south.xpm
WE ./textures_imgs/west.xpm
EA ./textures_imgs/east.xpm

F 220,100,0
C 225,30,0

11111111111111111111111111
10000000001 10000000000001
10110000011 10000000000001
10010000000 00000000000001
1111111101100000111000001
10000000001100001110N1111
1111011111111101110000001
1111011111111101110101001
1100000011010101110000001
1000000000000000110000001
1000000000000000110101001
1100000111010101111111111
1111011111101011111111001
11111111111111111111111111
