NO ./textures_imgs/north.xpm
SO ./textures_imgs/south.xpm
WE ./textures_imgs/west.xpm
EA ./textures_imgs/east.xpm

F 220,100,0
C 225,30,0

        1111111111
       11000000001
      111000N00001
     1111000000001
    111111111111111
   1111
  1111
 1111
1111
