NO ./textures_imgs/north.xpm
SO ./textures_imgs/south.xpm
WE ./textures_imgs/west.xpm
EA ./textures_imgs/east.xpm

F 255,255,255
C 128,128,128

1111111111111
1000000000001
100000N000001
1000000000001
1111111111111
