NO ./textures_imgs/north.xpm
SO ./textures_imgs/south.xpm
WE ./textures_imgs/west.xpm
EA ./textures_imgs/east.xpm

F 220,100,0
C 225,30,0

111111111
100000111
100N001
100000111
111111111
